11111111111111111111111111111111
10P0000C01C000100000000000C00011
10000E000100001000E0010000000001
10P0000C0000000000000000C0000001
111111111111111111111111111111P1
1EP000000000000000E00000C0000001
11111000000C00000P00000000001111
11111111111111111111111111111111
