11111111111111111111111111111111
1000000C01C000100000000000C00011
10000000010000100000010000000001
1000000C0000000000000000C0000001
11111111110111110111111111111101
1E0P00000000000000000000C0000001
11111000000C00000P00000000001111
11111111111111111111111111111111
