1111111111111111111
1P000000C0000E00001
100000P000000C00001
111111111C111111111
1000000C00E00P00001
1P00CC00000E00000P1
1111111111111111111
