111111111111111111111111
1CPPPPPPPPPEPPPPPPPPPPC1
1CPPPPPPPPPEPPPPPPPPPPC1
1CPPPPPPPPPEPPPPPPPPPPC1
1CPPPPPPPPPEPPPPPPPPPPC1
111111111111111111111111
