111111111111111111111111
100C000C00P0000E00000001
100P00000000000000000001
10000PC000000000000E0001
10C0000000P0000C000000C1
111111111111111111111111
