11111
10000
10001
10001
11111
