11111
100010
10001
10001
11111
