111111111111111111111
1CCC10000000000000001
101111111111000000001
10000CCCCCCCCCCCCCC01
10000P000001001110001
1E00000000CCCCCCCCC01
111111111111111111111
