1111111111111
1000000000001
10P0000000001
10P0000000001
10P0000000001
10P0000000001
10P0000000001
10P0000000001
1EC0000000001
1111111111111
