11111111111
1C0000000C1
10001010001
10E00P00E01
10001010001
1C0000000C1
11111111111
