1111111111111111111111111111111111111111
1000000000000000000000000000000000000001
100000000000000000000000P000000000000001
1000000000000000000000000000P00000000001
10000000P0000000000000000000000000000001
1000000000000000000000000000000000000001
10000000000000000000E000000P000000000001
10000000000000C0000000000000000000000001
1000000000000000000000000000000000000001
1111111111111111111111111111111111111111
