11111111111111111111111111
1CP000000000E0000000000PC1
1C0000000000E00000000000C1
1C0000000000E00000000000C1
1CP000000000E0000000000PC1
11111111111111111111111111
