1111111111
1P1E000C01
1000C0P001
1110E0P0E1
1P00101111
10CE1P00C1
1111111111
