11111
1CCC1
1PPP1
10001
1EEE1
11111
